-25
25
-13
13
000000000000000000000000000000000000000000000000000
111111111111111111111111111111111111111111111111110
000000000000000000000000000000000000000000000000000
000000000000000000000000000000000000000000000000000
000000000000000000000000000000000000000000000000000
000000000000000000000000000000000000000000000000000
000000000000000000000000000000000000000000000000000
000000000000000000000000000000000000000000000000000
000000000000000000000000000000000000000000000000000
000000000000000000000000000000000000000000000000000
000000000000000000000000000001111111000000000000000
000000000000000000000000000001111111000000000000000
000000000000000000000000000001111111000000000000000
000000000000001000000000000001111111000000000000000
000000000000000000000000000001111111000000000000000
000000000000000000000000000001111111000000000000000
000000000000000000000000000001111111000000000000000
000000000000000000000000000000000000000000000000000
000000000000000000000000000000000000000000000000000
000000000000000000000000000000000000000000000000000
000000000000000000000000000000000000000000000000000
000000000000000000000000000000000000000000000000000
000000000000000000000000000000000000000000000000000
000000000000000000000000000000000000000000000000000
000000000000000000000000000000000000000000000000000
000000000000000000000000000000000000000000000000000
000000000000000000000000000000000000000000000000000
