-25
25
-13
13
000000000000000000000000000000000000000000000000000
111111111111111111111111111111111111111111111111110
000000000000000000000000000000000000000000000000000
000000000000000000000000000000000000000000000000000
000000000000000000000000000000000000000000000000000
000000000000000000000000000000000000000000000000000
000000000000000000000000000000000000000000000000000
000000000000000000000000000000000000000000000000000
000000000000000000000000000000000000000000000000000
000000000000000000000000000000000000000000000000000
000000000000000000000100000001111111000000000000000
000000000000000000000100000001111111000000000000000
000000000000000000000100000001111111000000000000000
000000000010000000000111000001111111000000000000000
000000000010000000000000000001111111000000000000000
000000110011111100000000000001111111000000000000000
000000100010000000000000000001111111000000000000000
000000100010000000000000000000000000000000000000000
000000101111100000000000000000000000000000000000000
000000100000100000000000000000000000000000000000000
000000111100111000000000000000000000000000000000000
000000000000100000000000000000000000000000000000000
000000000000000000000000000000000000000000000000000
000000000000000000000000000000000000000000000000000
000000000000000000000000000000000000000000000000000
000000000000000000000000000000000000000000000000000
000000000000000000000000000000000000000000000000000
